000000000000000000000000000000000000000000000000000000000000000000000000000000000000000000000000000000000000000000000000000000000000000000000000
000000000000000000000000000000000000000000000000000000000000000000000001111111111111111111110000000000000000000000111111000000000000000000000000
000000111111111100000000000000000000000000000000000000000011111111111111111111111111111111111111111111111111111111111111100000000000000000000000
000000111111111111111111111111111111111111111111111111111111111111111111111111111111111111111111111111111111111111111111100000000000000000000000
000000111111111111111111111111111111111111111111111111111111111111111111111111111111111111111111111111111111111111111111100000000000000000000000
000111111111111111111111111111111111111111111111111111111111111111111111111111111111111111111111111111111111111111111111100000000000000000000000
000111111111111111111111111111111111111111111111111111111111111111111111111111111111111111111111111111111111111111111111100000000000000000000000
000111100000000000000000000000000000000000000000000000111111000000000000000000000000000000000000000000000000000000001111100000000000000000000000
000111100000000000000000000000000000000000000000000000111111000000000000000000000000000000000000000000000000000000001111100000000000000000000000
000111100000000000000000000000000000000000000000000000111111000000000000000000000000000000000000000000000000000000001111110000000000000000000000
000111100000000000000000000000000000000000000000000000111111000000000000000000000000000000000000000000000000000000001111110000000000000000000000
000111100000000000000000000000000000000000000000000000111111000000000000000000000000000000000000000000000000000000001111110000000000000000000000
000111100000000000000000000000000000000000000000000000111111000000000000000000000000000000000000000000000000000000001111110000000000000000000000
000111100000000000000000000000000000000000000000000000111111000000000000000000000000000000000000000000000000000000001111110000000000000000000000
000111100000000000000000000000000000000000000000000000111111000000000000000000000000000000000000000000000000000000001111110000000000000000000000
001111100000000000000000000000000000000000000000000000111111000000000000000000000000000000000000000000000000000000001111110000000000000000000000
001111100000000000000000000000000000000000000000000000111111000000000000000000000000000000000000000000000000000000001111110000000000000000000000
001111100000000000000000000000000000000000000000000000111111000000000000000000000000000000000000000000000000000000001111110000000000000000000000
001111100000000000000000000000000000000000000000000000111111000000000000000000000000000000000000000000000000000000001111110000000000000000000000
001111100000000000000000000000000000000000000000000000111111000000000000000000000000000000000000000000000000000000001111110000000000000000000000
001111100000000000000000000000000000000000000000000000111111000000000000000000000000000000000000000000000000000000001111110000000000000000000000
001111100000000000000000000000000000000000000000000000111111000000000000000000000000000000000000000000000000000000001111110000000000000000000000
001111100000000000000000000000000000000000000000000000111111000000000000000000000000000000000000000000000000000000001111110000000000000000000000
001111100000000000000000000000000000000000000000000000111111000000000000000000000000000000000000000000000000000000001111110000000000000000000000
001111100000000000000000000000000000000000000000000000111111000000000000000000000000000000000000000000000000000000001111110000000000000000000000
001111100000000000000000000000000000000000000000000000111111000000000000000000000000000000000000000000000000000000001111110000000000000000000000
001111100000000000000000000000000000000000000000000000111111000000000000000000000000000000000000000000000000000000001111110000000000000000000000
001111100000000000000000000000000000000000000000000000111111000000000000000000000000000000000000000000000000000000001111110000000000000000000000
001111100000000000000000000000000000000000000000000000111111000000000000000000000000000000000000000000000000000000001111110000000000000000000000
001111100000000000000000000000000000000000000000000000111111000000000000000000000000000000000000000000000000000000001111110000000000000000000000
001111100000000000000000000000000000000000000000000000111111000000000000000000000000000000000000000000000000000000001111110000000000000000000000
001111100000000000000000000000000000000001111111111111111111000000000000000000000000000000000000000000000000000000001111110000000000000000000000
001111100000000000000000001111111111111111111111111111111111000000000000000000000000000011111111111111000000000000001111110000000000000000000000
001111100000000000000000001111111111111111111111111111111111000000000000000000000000000011111111111111000000000000001111110000000000000000000000
001111100000000000000000001111111111111111111111111111111111000000000000000000000000000011111111111111000000000000001111110000000000000000000000
001111100000000000000001111111111111111111111111111111111111000000000000000000000000011111111111111111000000000000001111100000000000000000000000
001111100000000000000001111111111111111111111111111111111110000000000000000000000000011111111111111110000000000000001111100000000000000000000000
001111100000000000000001111110000000000000000000000000011110000000000000000000000000011111100000011110000000000000001111100000000000000000000000
001111100000000000000000111110000000000000000000000000000000000000000000000000000000011111100000000000000000000000001111100000000000000000000000
001111100000000000000001111110000000000000000000000000000000000000000000000000000000011111100000000000000000000000001111100000000000000000000000
001111100000000000000001111110000000000000000000000000000000000000000000000000000000011111100000000000000000000000001111100000000000000000000000
001111100000000000000001111110000000000000000000000000000000000000000000000000000000011111100000000000000000000000001111100000000000000000000000
001111100000000000000001111110000000000000000000000000000000000000000000000000000000011111100000000000000000000000001111100000000000000000000000
001111100000000000000001111110000000000000000000000000000000000000000000000000000000011111100000000000000000000000001111100000000000000000000000
001111100000000000000001111110000000000000000000000000000000000000000000000000000000011111000000000000000000000000001111100000000000000000000000
001111100000000000000001111110000000000000000000000000000000000000000000000000000000011111000000000000000000000000001111100000000000000000000000
001111100000000000000001111110000000000000000000000000000000000000000000000000000000011111000000000000000000000000001111100000000000000000000000
001111100000000000000001111110000000000000000000000000000000000000000000000000000000011111000000000000000000000000001111100000000000000000000000
001111100000000000000001111110000000000000000000000000000000000000000000000000000000011111000000000000000000000000001111100000000000000000000000
001111100000000000000001111110000000000000000000000000000000000000000000000000000000011111000000000000000000000000001111100000000000000000000000
001111100000000000000001111110000000000000000000000000000000000000000000000000000000011111000000000000000000000000001111100000000000000000000000
001111100000000000000001111110000000000000000001000000000000000000000000000000000000011111000000000000000000000000001111100000000000000000000000
001111100000000000000001111110000000000000000001100000000111000000000000000000000000011111000000000000000000000000001111100000000000000000000000
001111100000000000000001111110000000000000000001110000000111000000000000000000000000011111000000000000000000000000001111100000000000000000000000
001111100000000000000001111110000000000000001111110000000111000000000000000000000000011111000000000000000000000000001111100000000000000000000000
001111100000000000000001111110000000000000001111110000111111000000000000000000000000011111000000000000000000000000001111100000000000000000000000
001111100000000000000001111110000000000000001111110000111111000000000000000000000000011111000000000000000000000000001111100000000000000000000000
001111100000000000000001111110000000000000001111110000111111000000000000000000000000011111000000000000000000000000001111100000000000000000000000
001111100000000000000001111110000000000000001111110000111111000000000000000000000000011111000000000000000000000000001111100000000000000000000000
001111100000000000000001111110000000000000001111110000111111000000000000000000000000011111000000000000000000000000001111100000000000000000000000
001111100000000000000001111110000000000000001111110000111111000000000000000000000000011111000000000000000000000000001111100000000000000000000000
001111100000000000000001111110000000000000001111110000111111000000000000000000000000011111000000000000000000000200001111100000000000000000000000
001111100000000000000001111110000000000000001111110000111111000000000000000000100000011111000000000000000000000000001111100000000000000000000000
001111100000000000000000111110000000000000001111111111111111000000000000000001111111111111111111111111111111111111111111100000000000000000000000
001111100000000000000001111110000000000000001111111111111111000000000000000001111111111111111111111111111111111111111111100000000000000000000000
001111100000000000000001111110000000000000001111111111111111000000000000000111111111111111111111111111111111111111111111100000000000000000000000
001111100000000000000001111110000000000000001111111111111111000000000000001111111111111111111111111111111111111111111111100000000000000000000000
001111100000000000000001111100000000000000001111111111111111000000000000001111111111111111111111111111111111111111111111100000000000000000000000
001111100000000000000000000000000000000000000111111111111110000000000000001111110000000000000000000000000000000000001111100000000000000000000000
001111100000000000000000000000000000000000000000000000000000000000000000001111110000000000000000000000000000000000001111100000000000000000000000
001111100000000000000000000000000000000000000000000000000000000000000000001111110000000000000000000000000000000000001111100000000000000000000000
001111100000000000000000000000000000000000000000000000000000000000000000001111110000000000000000000000000000000000001111100000000000000000000000
001111100000000000000000000000000000000000000000000000000000000000000000001111110000000000000000000000000000000000001111100000000000000000000000
001111100000000000000000000000000000000000000000000000000000000000000000001111110000000000000000000000000000000000001111100000000000000000000000
001111100000000000000000000000000000000000000000000000000000000000000000001111110000000000000000000000000000000000001111100000000000000000000000
001111100000000000000000000000000000000000000000000000000000000000000000001111110000000000000000000000000000000000001111100000000000000000000000
001111100000000000000000000000000000000000000000000000000000000000000000001111110000000000000000000000000000000000001111100000000000000000000000
001111100000000000000000000000000000000000000000000000000000000000000000001111110000000000000000000000000000000000001111100000000000000000000000
001111100000000000000000000000000000000000000000000000000000000000000000001111110000000000000000000000000000000000001111100000000000000000000000
001111100000000000000000000000000000000000000000000000000000000000000000000000000000000000000000000000000000000000001111100000000000000000000000
001111100000000000000000000000000000000000000000000000000000000000000000000000000000000000000000000000000000000000001111100000000000000000000000
001111100000000000000000000000000000000000000000000000000000000000000000000000000000000000000000000000000000000000001111100000000000000000000000
001111100000000000000000000000000000000000000000000000000000000000000000000000000000000000000000000000000000000000001111100000000000000000000000
001111100000000000000000000000000000000000000000000000000000000000000000000000000000000000000000000000000000000000001111100000000000000000000000
001111100000000000000000000000000000000000000000000000000000000000000000000000000000000000000000000000000000000000001111100000000000000000000000
001111100000000000000000000000000000000000000000000000000000000000000000000000000000000000000000000000000000000000001111100000000000000000000000
001111100000000000000000000000000000000000000000000000000000000000000000000000000000000000000000000000000000000000001111110000000000000000000000
001111111111111110000000000000000000000000000000000000000000000000000000000000000000000000000000000000000000000000001111110000000000000000000000
001111111111111110000000000000000000000000000000000000000000000000000000000000000000000000000000000000000000000000001111110000000000000000000000
001111111111111110000000000000000000000000000000000000000000000000000000000000000000000000000000000000000000000000001111110000000000000000000000
001111111111111110000000000000000000000000000000000000000000000000000000000000000000000000000000000000000000000000001111110000000000000000000000
001111111111111110000000000000000000000000000000000000000000000000000000000000000000000000000000000000000000000000001111110000000000000000000000
001111111111111110000000000000000000000000000000000000000000000000000000000000000000000000000000000000000000000000001111110000000000000000000000
000000000000111110000000000000000000000000000000000000000000000000000000000000000000000000000000000000000000000000011111110000000000000000000000
000000000000111110000000000000000000000000000000000000000000000000000000000000000000000000000000000000000000000000011111110000000000000000000000
000000000000011111111111111111111111111111111111111111111111111111111111111111111111111111111111100000000000000000011111100000000000000000000000
000000000000011111111111111111111111111111111111111111111111111111111111111111111111111111111111111111111111111111111111100000000000000000000000
000000000000111111111111111111111111111111111111111111111111111111111111111111111111111111111111111111111111111111111111100000000000000000000000
000000000000011111111111111111111111111111111111111111111111111111111111111111111111111111111111111111111111111111111000000000000000000000000000
000000000000011111111111111111111111111111111111111111111111111111111111111111111111111111111111111111111111111111111000000000000000000000000000
000000000000111111111111111111111111111111111111111111111111111111111000000000000000000000000000000000000000000000000000000000000000000000000000
000000000000000000000000000000000000000000000000000000000000000000000000000000000000000000000000000000000000000000000000000000000000000000000000
000000000000000000000000000000000000000000000000000000000000000000000000000000000000000000000000000000000000000000000000000000000000000000000000
000000000000000000000000000000000000000000000000000000000000000000000000000000000000000000000000000000000000000000000000000000000000000000000000
