000000000000000000000000000000000000000000000000000000000000000000000000000000000000000000000000000000000000000000000000000000000000000000000000
000000000000000000000000000000000000000000000000000000000000000000000001111111111111111111110000000000000000000000111111000000000000000000000000
000000111111111100000000000000000000000000000000000000000011111111111111111111111111111111111111111111111111111111111111100000000000000000000000
000000111111111111111111111111111111111111111111111111111111111111111111111111111111111111111111111111111111111111111111100000000000000000000000
000000111111111111111111111111111111111111111111111111111111111111111111111111111111111111111111111111111111111111111111111111000000000000000000
000111111111111111111111111111111111111111111111111111111111111111111111111111111111111111111111111111111111111111111111111111100000000000000000
000111111111111111111111111111111111111111111111111111111111111111111111111111111111111111111111111111111111111111111111111111100000000000000000
000111111111111111111111111111111111111111111111111111111111111111111111111111111111111111111111111111111111111111111111111111100000000000000000
000111111111111111111111111111111111111111111111111111111111111111111111111111111111111111111111111111111111111111111111111111100000000000000000
000111111111111111111111111111111111111111111111111111111111111111111111111111111111111111111111111111111111111111111111111111100000000000000000
000111111111100000000000000000000000000000000000000000111111111111000000000000000000000000000000000000000000000000001111111111100000000000000000
000111111111100000000000000000000000000000000000000000111111111111000000000000000000000000000000000000000000000000001111111111100000000000000000
000111111111100000000000000000000000000000000000000000111111111111000000000000000000000000000000000000000000000000001111111111110000000000000000
000111111111100000000000000000000000000000000000000000111111111111000000000000000000000000000000000000000000000000001111111111110000000000000000
000111111111100000000000000000000000000000000000000000111111111111000000000000000000000000000000000000000000000000001111111111110000000000000000
001111111111100000000000000000000000000000000000000000111111111111000000000000000000000000000000000000000000000000001111111111110000000000000000
001111111111100000000000000000000000000000000000000000111111111111000000000000000000000000000000000000000000000000001111111111110000000000000000
001111111111100000000000000000000000000000000000000000111111111111000000000000000000000000000000000000000000000000001111111111110000000000000000
001111111111100000000000000000000000000000000000000000111111111111000000000000000000000000000000000000000000000000001111111111110000000000000000
001111111111100000000000000000000000000000000000000000111111111111000000000000000000000000000000000000000000000000001111111111110000000000000000
001111111111100000000000000000000000000000000000000000111111111111000000000000000000000000000000000000000000000000001111111111110000000000000000
001111111111100000000000000000000000000000000000000000111111111111000000000000000000000000000000000000000000000000001111111111110000000000000000
001111111111100000000000000000000000000000000000000000111111111111000000000000000000000000000000000000000000000000001111111111110000000000000000
001111111111100000000000000000000000000000000000000000111111111111000000000000000000000000000000000000000000000000001111111111110000000000000000
001111111111100000000000000000000000000000000000000000111111111111000000000000000000000000000000000000000000000000001111111111110000000000000000
001111111111100000000000000000000000000000000000000000111111111111000000000000000000000000000000000000000000000000001111111111110000000000000000
001111111111100000000000000000000000000000000000000000111111111111000000000000000000000000000000000000000000000000001111111111110000000000000000
001111111111100000000000000000000000000000000000000000111111111111000000000000000000000000000000000000000000000000001111111111110000000000000000
001111111111100000000000000000000000000000000000000000111111111111000000000000000000000000000000000000000000000000001111111111110000000000000000
001111111111100000000000000000000000000000000000000000111111111111000000000000000000000000000000000000000000000000001111111111110000000000000000
001111111111100000000000000000000000000000000000000000111111111111000000000000000000000000000000000000000000000000001111111111100000000000000000
001111111111100000000000000000000000000001111111111111111111111111000000000000000000000000000000000000000000000000001111111111110000000000000000
001111111111100000000000001111111111111111111111111111111111111111000000000000000000000011111111111111000000000000001111111111110000000000000000
001111111111100000000000001111111111111111111111111111111111111111000000000000000000000011111111111111000000000000001111111111110000000000000000
001111111111100000000000001111111111111111111111111111111111111111000000000000000000000011111111111111000000000000001111111111110000000000000000
001111111111100000000001111111111111111111111111111111111111111111000000000000000000011111111111111111111111000000001111111111100000000000000000
001111111111100000000001111111111111111111111111111111111111111110000000000000000000011111111111111111111110000000001111111111100000000000000000
001111111111100000000001111111111111111111111111111111111111111110000000000000000000011111111111111111111110000000001111111111100000000000000000
001111111111100000000000111111111111111111111111111111111111000000000000000000000000011111111111111111000000000000001111111111100000000000000000
001111111111100000000001111111111111111111111111111111111110000000000000000000000000011111111111111110000000000000001111111111100000000000000000
001111111111100000000001111111111110000000000000000000000010000000000000000000000000011111111111100010000000000000001111111111100000000000000000
001111111111100000000001111111111110000000000000000000000000000000000000000000000000011111111111100000000000000000001111111111100000000000000000
001111111111100000000001111111111110000000000000000000000000000000000000000000000000011111111111100000000000000000001111111111100000000000000000
001111111111100000000001111111111110000000000000000000000000000000000000000000000000011111111111100000000000000000001111111111100000000000000000
001111111111100000000001111111111110000000000000000000000000000000000000000000000000011111111111000000000000000000001111111111100000000000000000
001111111111100000000001111111111110000000000000000000000000000000000000000000000000011111111111000000000000000000001111111111100000000000000000
001111111111100000000001111111111110000000000000000000000000000000000000000000000000011111111111000000000000000000001111111111100000000000000000
001111111111100000000001111111111110000000000000000000000000000000000000000000000000011111111111000000000000000000001111111111100000000000000000
001111111111100000000001111111111110000000000000000000000000000000000000000000000000011111111111000000000000000000001111111111100000000000000000
001111111111100000000001111111111110000000000000000000000000000000000000000000000000011111111111000000000000000000001111111111100000000000000000
001111111111100000000001111111111110000000000000000000000000000000000000000000000000011111111111000000000000000000001111111111100000000000000000
001111111111100000000001111111111110000000000001000000000000000000000000000000000000011111111111000000000000000000001111111111100000000000000000
001111111111100000000001111111111110000000000001100000000111000000000000000000000000011111111111000000000000000000001111111111100000000000000000
001111111111100000000001111111111110000000000001110000000111000000000000000000000000011111111111000000000000000000001111111111100000000000000000
001111111111100000000001111111111110000000001111111111000111000000000000000000000000011111111111000000000000000000001111111111100000000000000000
001111111111100000000001111111111110000000001111111111111111111111000000000000000000011111111111000000000000000000001111111111100000000000000000
001111111111100000000001111111111110000000001111111111111111111111000000000000000000011111111111000000000000000000001111111111100000000000000000
001111111111100000000001111111111110000000001111111111111111111111000000000000000000011111111111000000000000000000001111111111100000000000000000
001111111111100000000001111111111110000000001111111111111111111111000000000000000000011111111111000000000000000000001111111111100000000000000000
001111111111100000000001111111111110000000001111111111111111111111000000000000000000011111111111000000000000000000001111111111100000000000000000
001111111111100000000001111111111110000000001111111111111111111111000000000000000000011111111111000000000000000000001111111111100000000000000000
001111111111100000000001111111111110000000001111111111111111111111000000000000000000011111111111000000000000000200001111111111100000000000000000
001111111111100000000001111111111110000000001111111111111111111111000000000000100000011111111111000000000000000000001111111111100000000000000000
001111111111100000000000111111111110000000001111111111111111111111000000000001111111111111111111111111111111111111111111111111100000000000000000
001111111111100000000001111111111110000000001111111111111111111111000000000001111111111111111111111111111111111111111111111111100000000000000000
001111111111100000000001111111111110000000001111111111111111111110000000000111111111111111111111111111111111111111111111111111100000000000000000
001111111111100000000001111111111110000000001111111111111111111111000000001111111111111111111111111111111111111111111111111111100000000000000000
001111111111100000000001111111111100000000001111111111111111111111000000001111111111111111111111111111111111111111111111111111100000000000000000
001111111111100000000000001110000000000000000111111111111111111110000000001111111111111111111111111111111111111111111111111111100000000000000000
001111111111100000000000001110000000000000000001111111111111000000000000001111111111111111111111111111111111111111111111111111100000000000000000
001111111111100000000000001100000000000000000001111111111111000000000000001111111111111111111111111111111111111111111111111111100000000000000000
001111111111100000000000000000000000000000000000111111100010000000000000001111111111110000000000000000000000000000001111111111100000000000000000
001111111111100000000000000000000000000000000000000000000000000000000000001111111111110000000000000000000000000000001111111111100000000000000000
001111111111100000000000000000000000000000000000000000000000000000000000001111111111110000000000000000000000000000001111111111100000000000000000
001111111111100000000000000000000000000000000000000000000000000000000000001111111111110000000000000000000000000000001111111111100000000000000000
001111111111100000000000000000000000000000000000000000000000000000000000001111111111110000000000000000000000000000001111111111100000000000000000
001111111111100000000000000000000000000000000000000000000000000000000000001111111111110000000000000000000000000000001111111111100000000000000000
001111111111100000000000000000000000000000000000000000000000000000000000001111111111110000000000000000000000000000001111111111100000000000000000
001111111111100000000000000000000000000000000000000000000000000000000000001111111111110000000000000000000000000000001111111111100000000000000000
001111111111100000000000000000000000000000000000000000000000000000000000000001110000000000000000000000000000000000001111111111100000000000000000
001111111111100000000000000000000000000000000000000000000000000000000000000001110000000000000000000000000000000000001111111111100000000000000000
001111111111100000000000000000000000000000000000000000000000000000000000000001110000000000000000000000000000000000001111111111100000000000000000
001111111111100000000000000000000000000000000000000000000000000000000000000000000000000000000000000000000000000000001111111111100000000000000000
001111111111100000000000000000000000000000000000000000000000000000000000000000000000000000000000000000000000000000001111111111100000000000000000
001111111111100000000000000000000000000000000000000000000000000000000000000000000000000000000000000000000000000000001111111111100000000000000000
001111111111100000000000000000000000000000000000000000000000000000000000000000000000000000000000000000000000000000001111111111100000000000000000
001111111111100000000000000000000000000000000000000000000000000000000000000000000000000000000000000000000000000000001111111111100000000000000000
001111111111111110000000000000000000000000000000000000000000000000000000000000000000000000000000000000000000000000001111111111100000000000000000
001111111111111110000000000000000000000000000000000000000000000000000000000000000000000000000000000000000000000000001111111111100000000000000000
001111111111111110000000000000000000000000000000000000000000000000000000000000000000000000000000000000000000000000001111111111110000000000000000
001111111111111111111110000000000000000000000000000000000000000000000000000000000000000000000000000000000000000000001111111111110000000000000000
001111111111111111111110000000000000000000000000000000000000000000000000000000000000000000000000000000000000000000001111111111110000000000000000
001111111111111111111110000000000000000000000000000000000000000000000000000000000000000000000000000000000000000000001111111111110000000000000000
000001111111111111111110000000000000000000000000000000000000000000000000000000000000000000000000000000000000000000011111111111110000000000000000
000001111111111111111110000000000000000000000000000000000000000000000000000000000000000000000000000000000000000000011111111111110000000000000000
000001111111111111111111111111111111111111111111111111111111111111111111111111111111111111111111100000000000000000011111111111100000000000000000
000000000000011111111111111111111111111111111111111111111111111111111111111111111111111111111111111111111111111111111111111111100000000000000000
000000000000111111111111111111111111111111111111111111111111111111111111111111111111111111111111111111111111111111111111111111100000000000000000
000000000000011111111111111111111111111111111111111111111111111111111111111111111111111111111111111111111111111111111111111000000000000000000000
000000000000011111111111111111111111111111111111111111111111111111111111111111111111111111111111111111111111111111111111111000000000000000000000
000000000000111111111111111111111111111111111111111111111111111111111111111111111111111111111111111111111111111111111111100000000000000000000000
000000000000000111111111111111111111111111111111111111111111111111111111111111111111111111111111111111111111111111111000000000000000000000000000
000000000000000111111111111111111111111111111111111111111111111111111111111111111111111111111111111111111111111111111000000000000000000000000000
000000000000000111111111111111111111111111111111111111111111111111111000000000000000000000000000000000000000000000000000000000000000000000000000
