000000000000000000000000000000000000000000000000000000000000000000000000000000000000000000000000000000000000000000000000000000000000000000000000
000000000000000000000000000000000000000000000000000000000000000000000000000000000000000000000000000000000000000000000000000000000000000000000000
000000000000000000000000000000000000000000000000000000000000000000000000000000000000000000000000000000000000000000000000000000000000000000000000
000000000000000000000000000000000000000000000000000000000000000000000000000000000000000000000000000000000000000000000000000000000000000000000000
000000000000000011111111111111111111111111111111111111111111111111111100000000000000000000000000000000000000000000000000000000000000000000000000
000000000000000011111111111111111111111111111111111111111111111111111111111111111111111111111111111111111111111111111000000000000000000000000000
000000000000000011111111111111111111111111111111111111111111111111111111111111111111111111111111100000000000000000011000000000000000000000000000
000000000000000110000000000000000000000000000000000000000000000000000000000000000000000000000000000000000000000000011111100000000000000000000000
000000000000000010000000000000000000000000000000000000000000000000000000000000000000000000000000000000000000000000011111110000000000000000000000
000000000000000110000000000000000000000000000000000000000000000000000000000000000000000000000000000000000000000000000001110000000000000000000000
000000000000000010000000000000000000000000000000000000000000000000000000000000000000000000000000000000000000000000000001110000000000000000000000
000000000000000010000000000000000000000000000000000000000000000000000000000000000000000000000000000000000000000000000001110000000000000000000000
000001111111111110000000000000000000000000000000000000000000000000000000000000000000000000000000000000000000000000000001110000000000000000000000
000001111111111110000000000000000000000000000000000000000000000000000000000000000000000000000000000000000000000000000001110000000000000000000000
000001111111111110000000000000000000000000000000000000000000000000000000000000000000000000000000000000000000000000000001110000000000000000000000
000001100000000000000000000000000000000000000000000000000000000000000000000000000000000000000000000000000000000000000001110000000000000000000000
000001100000000000000000000000000000000000000000000000000000000000000000000000000000000000000000000000000000000000000001100000000000000000000000
000001100000000000000000000000000000000000000000000000000000000000000000000000000000000000000000000000000000000000000001100000000000000000000000
000001100000000000000000000000000000000000000000000000000000000000000000000000000000000000000000000000000000000000000001100000000000000000000000
000001100000000200000000000000000000000000000000000000000000000000000000000000000000000000000000000000000000000000000001100000000000000000000000
000001100000000000000000000000000000000000000000000000000000000000000000000000000000000000000000000000000000000000000001100000000000000000000000
000001100000000000000000000000000000000000000000000000000000000000000000000000000000000000000000000000000000000000000001100000000000000000000000
000001100000000000000000000000000000000000000000000000000000000000000000000000000000000000000000000000000000000000000001100000000000000000000000
000001100000000000000000000000000000000000000000000000000000000000000000000000000000000000000000000000000000000000000001100000000000000000000000
000001100000000000000000000000000000000000000000000000000000000000000000000000000000000000000000000000000000000000000001100000000000000000000000
000001100000000000000000000000000000000000000000000000000000000000000000000000000000000000000000000000000000000000000001100000000000000000000000
000001100000000000000000000000000000000000000000000000000000000000000000000001110000000000000000000000000000000000000001100000000000000000000000
000001100000000000000000000000000000000000000000000000000000000000000000000001110000000000000000000000000000000000000001100000000000000000000000
000001100000000000000000000000000000000000000000000000000000000000000000000001110000000000000000000000000000000000000001100000000000000000000000
000001100000000000000000000000000000000000000000000000000000000000000000000001110000000000000000000000000000000000000001100000000000000000000000
000001100000000000000000000000000000000000000000000000000000000000000000000001110000000000000000000000000000000000000001100000000000000000000000
000001100000000000000000000000000000000000000000000000000000000000000000000001110000000000000000000000000000000000000001100000000000000000000000
000001100000000000000000000000000000000000000000000000000000000000000000000001110000000000000000000000000000000000000001100000000000000000000000
000001100000000000000000000000000000000000000000000000000000000000000000000001110000000000000000000000000000000000000001100000000000000000000000
000001100000000000000000000000000000000000000000000000000000000000000000000001110000000000000000000000000000000000000001100000000000000000000000
000001100000000000000000000000000000000000000000000000000000000000000000000001110000000000000000000000000000000000000001100000000000000000000000
000001100000000000000000000000000000000000000000111111100010000000000000000001110000000000000000000000000000000011100001100000000000000000000000
000001100000000000000000001100000000000000000001111111111111000000000000000001111111111111111111111111111111111111111111100000000000000000000000
000001100000000000000000001110000000000000000001111111111111000000000000000001111111111111111111111111111111111111111111100000000000000000000000
000001100000000000000000001110000000000000000001100000000111000000000000000000100000000011000000000000000000000000000001100000000000000000000000
000001100000000000000000001110000000000000000001100000000111000000000000000000000000000011000000000000000000000000000001100000000000000000000000
000001100000000000000000001110000000000000000001100000000111000000000000000000000000000011000000000000000000000000000001100000000000000000000000
000001100000000000000000001110000000000000000001100000000111000000000000000000000000000011000000000000000000000000000001100000000000000000000000
000001100000000000000000001110000000000000000001100000000111000000000000000000000000000011000000000000000000000000000001100000000000000000000000
000001100000000000000000001110000000000000000001100000000111000000000000000000000000000011000000000000000000000000000001100000000000000000000000
000001100000000000000000001110000000000000000001100000000111000000000000000000000000000011000000000000000000000000000001100000000000000000000000
000001100000000000000000001110000000000000000001100000000111000000000000000000000000000011000000000000000000000000000001100000000000000000000000
000001100000000000000000001110000000000000000001100000000111000000000000000000000000000011000000000000000000000000000001100000000000000000000000
000001100000000000000000001110000000000000000001100000000111000000000000000000000000000011000000000000000000000000000001100000000000000000000000
000001100000000000000000001110000000000000000001110000000111000000000000000000000000000011000000000000000000000000000001100000000000000000000000
000001100000000000000000001110000000000000000001000000000000000000000000000000000000000011000000000000000000000000000001100000000000000000000000
000001100000000000000000001110000000000000000000000000000000000000000000000000000000000011000000000000000000000000000001100000000000000000000000
000001100000000000000000001110000000000000000000000000000000000000000000000000000000000011000000000000000000000000000001100000000000000000000000
000001100000000000000000001110000000000000000000000000000000000000000000000000000000000011000000000000000000000000000001100000000000000000000000
000001100000000000000000001110000000000000000000000000000000000000000000000000000000000011000000000000000000000000000001100000000000000000000000
000001100000000000000000001110000000000000000000000000000000000000000000000000000000000011000000000000000000000000000001100000000000000000000000
000001100000000000000000001110000000000000000000000000000000000000000000000000000000000011000000000000000000000000000001100000000000000000000000
000001100000000000000000001110000000000000000000000000000000000000000000000000000000000011000000000000000000000000000001100000000000000000000000
000001100000000000000000001110000000000000000000000000000000000000000000000000000000000011000000000000000000000000000001100000000000000000000000
000001100000000000000000001110000000000000000000000000000000000000000000000000000000000011000000000000000000000000000001100000000000000000000000
000001100000000000000000001110000000000000000000000000000000000000000000000000000000000011000000000000000000000000000001100000000000000000000000
000001100000000000000000001110000000000000000000000000000000000000000000000000000000000011100000000000000000000000000001100000000000000000000000
000001100000000000000000001110000000000000000000000000000000000000000000000000000000000011100000000000000000000000000001100000000000000000000000
000001100000000000000000001110000000000000000000000000000000000000000000000000000000000011100000000000000000000000000001100000000000000000000000
000001100000000000000000001110000000000000000000000000000000000000000000000000000000000011100000000000000000000000000001100000000000000000000000
000001100000000000000000001110000000000000000000000000000000000000000000000000000000000011100000000000000000000000000001100000000000000000000000
000001100000000000000000001110000000000000000000000000000000000000000000000000000000000011100000000000000000000000000001100000000000000000000000
000001100000000000000000001110000000000000000000000000000000000000000000000000000000000011000000000000000000000000000001100000000000000000000000
000001100000000000000000001111111111111111111111111111111110000000000000000000000000000011111111111110000000000000000001100000000000000000000000
000001100000000000000000001111111111111111111111111111111111000000000000000000000000000011111111111111000000000000000001100000000000000000000000
000000100000000000000000000000000000000001111111111111111111000000000000000000000000000000000000000000000000000000000001100000000000000000000000
000001100000000000000000000000000000000000000000000000000111000000000000000000000000000000000000000000000000000000000001100000000000000000000000
000001100000000000000000000000000000000000000000000000000111000000000000000000000000000000000000000000000000000000000001100000000000000000000000
000001100000000000000000000000000000000000000000000000000111000000000000000000000000000000000000000000000000000000000001100000000000000000000000
000000100000000000000000000000000000000000000000000000000111000000000000000000000000000000000000000000000000000000000001100000000000000000000000
000000100000000000000000000000000000000000000000000000000111000000000000000000000000000000000000000000000000000000000001100000000000000000000000
000000100000000000000000000000000000000000000000000000000111000000000000000000000000000000000000000000000000000000000001100000000000000000000000
000000100000000000000000000000000000000000000000000000000111000000000000000000000000000000000000000000000000000000000001100000000000000000000000
000000100000000000000000000000000000000000000000000000000111000000000000000000000000000000000000000000000000000000000001100000000000000000000000
000000100000000000000000000000000000000000000000000000000111000000000000000000000000000000000000000000000000000000000001100000000000000000000000
000000100000000000000000000000000000000000000000000000000111000000000000000000000000000000000000000000000000000000000001100000000000000000000000
000000100000000000000000000000000000000000000000000000000111000000000000000000000000000000000000000000000000000000000001100000000000000000000000
000000100000000000000000000000000000000000000000000000000111000000000000000000000000000000000000000000000000000000000001100000000000000000000000
000000100000000000000000000000000000000000000000000000000111000000000000000000000000000000000000000000000000000000000001100000000000000000000000
000000100000000000000000000000000000000000000000000000000111000000000000000000000000000000000000000000000000000000000001100000000000000000000000
000000100000000000000000000000000000000000000000000000000111000000000000000000000000000000000000000000000000000000000001100000000000000000000000
000000100000000000000000000000000000000000000000000000000110000000000000000000000000000000000000000000000000000000000001100000000000000000000000
000000100000000000000000000000000000000000000000000000000110000000000000000000000000000000000000000000000000000000000001100000000000000000000000
000000100000000000000000000000000000000000000000000000000110000000000000000000000000000000000000000000000000000000000001100000000000000000000000
000000100000000000000000000000000000000000000000000000000110000000000000000000000000000000000000000000000000000000000001100000000000000000000000
000000100000000000000000000000000000000000000000000000000110000000000000000000000000000000000000000000000000000000000001100000000000000000000000
000000100000000000000000000000000000000000000000000000000110000000000000000000000000000000000000000000000000000000000001100000000000000000000000
000000100000000000000000000000000000000000000000000000000111000000000000000000000000000000000000000000000000000000000001100000000000000000000000
000000100000000000000000000000000000000000000000000000000111000000000000000000000000000000000000000000000000000000000001100000000000000000000000
000000100000000000000000000000000000000000000000000000000111000000000000000000000000000000000000000000000000000000000001000000000000000000000000
000000100000000000000000000000000000000000000000000000000111000000000000000000000000000000000000000000000000000000000001100000000000000000000000
000000100000000000000000000000000000000000000000000000000111000000000000000000000000000000000000000000000000000000000001100000000000000000000000
000000100000000000000000000000000000000000000000000000000111000000000000000000000000000000000000000000000000000000000001100000000000000000000000
000000111111111111111111111111111111111111111111111111111111111111111111111111111111111111111111111111111111111111111111100000000000000000000000
000000000000000000000000000000000000000000000000000000000011111111111111111111111111111111111111111111111111111111111111000000000000000000000000
000000000000000000000000000000000000000000000000000000000000000000000001111111111111100000000000000000000000000001111111000000000000000000000000
000000000000000000000000000000000000000000000000000000000000000000000000000000000000000000000000000000000000000000000000000000000000000000000000
000000000000000000000000000000000000000000000000000000000000000000000000000000000000000000000000000000000000000000000000000000000000000000000000
000000000000000000000000000000000000000000000000000000000000000000000000000000000000000000000000000000000000000000000000000000000000000000000000
